WE ./bonus/texture/we.png
NO ./bonus/texture/no.png
EA ./bonus/texture/ea.png
SO ./bonus/texture/so.png


F 70,130,180
C 50,50,50

11111111111111111111111
11111100000000000000001
10000000000000000000001
10000000000000000000001
10000011111111D11110001
10001000000000000000001
10000N00000000000000001
10000000000000000000001
100000011111D1100000001
10000000000000000000001
10001111100000000000001
10000000000000000000001
11111111111111111111111
